NO./textures/flowers.png
SO./textures/wall_flower.png
WE./textures/brick.png
EA./textures/tiles.png

EA./textures/bush.xpm42
C255,045,45
F0,180,50   
hjgfchjklö     
    1111111111111111111111111
    10000000001100000  000001
    1011000001110000000000001
	1001000000000000000000001
111111111111111111111000000000001
100000000011000001110111111111111
11110111111111011100000000001
11110111111111011101010010001
11000000110101011100000000001
100000 0000000000000000000001
1000S000000000001101010010001
11000001110101011111011110001
11110111111101011101111010001
11111111111111111111111111111