NO./textures/floor.xpm42
SO./textures/tree.xpm42
WE./textures/acorn.xpm42
EA./textures/bush.xpm42
C255,045,45
F0,180,50
	1111111111111111111111111111111111111111111111111111111111111111111111111
111111111000000000000000000000000000000000000000000000000000000000000000000001
    	10000W0000000000000000000000000000000000000000000000000000000000000001
11111111100000000000000000000000000000000000000000000000000000000000000000001
11111111111110000000000000000000000000000000000000000000000000000000000000001
			11000000000000000000000000000000000000000000000000000000000000001
1111111111110000000000000000000000000000000000000000000000000000000000000001
11111111111111111111111111111111111111111111111111111111111111111111111111111