NO./textures/flowers.png
SO./textures/wall_brick.png
WE./textures/brick.png
EA./textures/wall_flower.png

F 30,30,30
C 250,150,150
111111111111111111111111
1S1000000000000000100011
101001011111111010101011
101001000100000010001001
101001111101111110111111
100001000101000000000001
111111100111011111111101
100011000100000000010001
101001101110111011110111           1111111
100100000100000010010001           1000001
110101110101010001011101111111111111000001
100100010101010101000000000000000000000001
101111110101010101011111111111111111000001
111000010101010101000001           1000001
100000000101010001111101           1111111
100000001001010101000111
111111111111000101010001
110100000001111101011101
110001111000000001010001
110100001011111111010111
110111111010000010010001
101100000000111111111101
100001111000000000000001
111111111111111111111111