NO./textures/coral.png
SO./textures/dolphin.png
WE./textures/mosaic.png
EA./textures/water.png
C200,200,255
F60,80,255
111111111111111111111111111111111111111111
1E0011100000000000000000000000000001110001
100000000000000000000000000000000000000001
110000000111111111110111111111110000000011
110000000100000000000000000000010000000011
110000000100000000110110000000001000000011
110000000000000000000000000000000000000011
110000000100000000110110000000010000000011
110000000100000000000000000000010000000011
110000000111111111110111111111110000000011
110000000000000000000000000000000000000001
100011100000000000000000000000000001110001
111111111111111111111111111111111111111111