NO./textures/coral.png
SO./textures/dolphin.png
WE./textures/mosaic.png
EA./textures/water.png
C200,200,255
F60,80,255
111111111111111111111111111111111111111111
1E0000000000000000000000000000000000000001
100000000000000000000000000000000000000001
100000000111111111110111111111110000000001
100000000100000000000000000000010000000001
100000000100000000110110000000001000000001
100000000000000000000000000000000000000001
100000000100000000110110000000010000000001
100000000100000000000000000000010000000001
100000000111111111110111111111110000000001
100000000000000000000000000000000000000001
100000000000000000000000000000000000000001
111111111111111111111111111111111111111111