NO./textures/floor.xpm42
lknjbhvgcffcgv
SO./textures/tree.xpm42
WE./textures/acorn.xpm42
njbhvggv
EA./textures/bush.xpm42
C255,045,45
F0,180,50
lmknjbhvgfcv
asdasdasdasdasdasdasdasdasdasd
1111111111111111
011100111000E001
0100000000111111
0111111110000001
1111111111111111
