NO./textures/steel2.png
SO./textures/steel4.png
WE./textures/steel5.png
EA./textures/steel3.png
C100,100,100
F20,20,20
111111111111111111111111111111111111111111
1E0010000000000000000000000000000000000001
100010001101100001101100011011000000000001
100010001000100001000100010001000000000001
100010001111100001111100011111000000000001
100010000000000000000000000000000000000001
100010000110110001111100000000000000000001
100010000100010001111100000000000000000001
100010000111110001111100000000000000000001
100000000000000000000000000000000000000001
100000000000000000000000000000000000000001
100000001111100000000000000001111100000001
111111111111111111111111111111111111111111