NO./textures/flowers.png
SO./textures/wall_flower.png
WE./textures/brick.png
EA./textures/tiles.png
F 100,100,100
C 0,210,255
1111111111111111111111111111111111111
0000000000000000000000W00000000000001
1000000000000000000000000000000000011
1000000000000000000000000000000000011
1000001111100001010100000000000000011
1000001000100000000000000000000000011
1000001000100001000100000000000000011
1000001000100000000000000000000000011
1000001101100001010100000000000000011
1000000000000000000000000000000000011
1111111111101111111111111111111111111
        1110111
		1110111
		1110111
		1110111
		1110111
		1110111
		1110111
1111111111101111111111111111111111111
1000000000000000000000000000000000011
1000000000000000000000000000000000011
1000000000000000000000000000000000011
1111111110000000000000000000000000011
1101000010000000000000000000000000011
1100001010000000000000000000000000011
1101000010000000000000000000000000011
1101111110000000000000000000000000011
1100000000000000000000000000000000011
1111111110000000000000000000000000011
1111111111111111111111111111111111111